#           #
#           #
#        ## #
#           #
#   ###   C #
#         # #
#       ### #
#    #      #
#           #
#############