#           #
#           #
#        ## #
#           #
#   ###     #
#         # #
#       ### #
#    #      #
#############