#           #
# ##        #
#       #  ##
#           #
#   #       #
#       C   #
#       #   #
#    #      #
#############