#           #
# ##        #
#   #       #
#           #
#           #
#       C # #
#       ### #
#    #      #
#############