#           #
# ##        #
#   #       #
#           #
#   ###     #
#         # #
#       ### #
#    #      #
#############