#           #
# ##        #
#       #  ##
#           #
#   #       #
#      C    #
#       #   #
#    #      #
#############